111111111111111111111111
100000000000000000000001
100000000000000000000001
111111100000000000000001
116000111110000303030001
111000000010000000000001
111000100010000300030001
111000100010000000000001
111000110110000303030001
111111100000000000000001
100000000000000000000001
100000000000000000000001
100000000000000000000001
100000000000000000000001
100000000000000000000001
100000000000000000000001
111111111000000000000001
110100001000000000000001
110000501000000000000001
110100001000000000000001
110111111000000000000001
110000000000000000000001
111111111000000000000001
111111111111111111111111
