111111111111111111111111111111
144444444444444444444444444441
144444444404404404404444444441
144444440044400004440044444441
144444000444400004444000444441
144400000444400004444000004441
140000000044400004440000a00041
140000000000000000000000000041
14000000000000b000000000000041
14000000000000b000000000000041
140000000000000000000000000041
144000444400400004004444000041
144400044444400004444440004441
144400044444400004444400004441
144464404444404404444404454441
144444444444444444444444444441
144444444444444444444444444441
144444444444444444444444444441
144444444444444444444444444441
111111111111111111111111111111
