1111111111111111111111111111111111111111111111111111111111111111111111111111111111111111111111111111
1111633303033330300333000330033033033000303333303303303033333330333000303333333303303033330033333301
1111030000033033330300330303033333333033333330033303330303303333333033333333033303030300333333033331
1111333033333003033330033303300333333333003303333333003300030333303030333030333300333333033030000331
1003333333333333033030303030033333030030303333033330033303333300303330300003333030033333303333333301
1333330330303303333330030333330333303333333030333330003330333333333330333003033300333333303303033331
1033330300333330333330303333300333333330333033333333330303033003333033330330033000330003033333303331
1330333333000033003033003303030303303000033330330033333033000330330333333333330030303003030003033331
1033333333033303333030333333033303333330303330300333033333333333330030333333330003303033303033303301
1333333330303300333303033330333333033333330303033030333030333033333033033333030333333300303330300331
1333333333033000303033330303033033033330330333330333033003330333033030003303003333330030330303003331
1333330030003333333333303303333300033333333033333003333030030333033300033033330330303333033330333331
1330333330333303330330033033333003333033333330333333303303033003033333333330300333030330330333333301
1333030033333330300333333033330000333303033033333303330333003303333333330333303000003000303030303031
1030330303300330033300003033033333330330033303303003033333330333330330333333333333333333030333303031
1033003033303333333303333033330300303330333033333333303033330333033330033030330033030300333333333331
1333303333333003033000003033033333333333333303303333333333333330030333333033333333333333303030333031
1033003303330333303003333303033033300333330303330300033330300033333333333333333303303330330333333031
1033003330303030030330303330033333330303333330303330003333303330330333333300300333330003300303300031
1033033030333033333303333303300303033300333300330333333330000333033033030030333333033033333033333331
1330330333330333333330003330030333333033300330333333003333033333333300333333333300333000033330003301
1303000330333330003030033333300333300303003330333303333303303333333303300303033033330033033333333031
1333333300003330033033330330333333303030333333333330333333003303030333333333303303330333303333300001
1330303033333033330303033303303033333333300303333033033330300330333333303330303333030303033333333331
1333033303033333333303333030333333030330333333330330333333330330003333333300303303030330300003300301
1333333000033003330303030333333000033030033003333333333300333333333000300333333033003033330330333331
1303303033303033330030303303003303333333033330330333030033330303030033333303333333333300333330333031
1303030303303333333333330333000030333333333033330333333030333030333300033333303333303303000330000001
1003303033333300333300330303333333333333333300303333333030333330033030333030333033333030333300300331
1333303000303303003330303303333330000333333333030330330303303033003300333333003330330030300303333301
1333003303030330333303030030333033303003333303330330333330330300333330333003333303003033030333033331
1003003303300333303003300303303003300303033330303333333330303303330003333303333033330003033303330331
1333333033303333300333333003333303300003300303333330000333330333033300333300333000300030033303333001
1333000333333303003303303333303030333333033000333333303003333033033303030303033333330003300333033331
1333333303303333333033303303333033333330333303033330333333030300300303330330303330333000033333033331
1330033003003330333333330333333333303303303003330303033333333333333330333333030033333303333330303331
1033333333033303003033333033333030333333303030000033330303303300330033333333333030030300303333000331
1033000333330003033303333033333303033033033330303303030003303333300003333333303033333303333333303301
1333000033300000330330303330033333003333333330333003333303033030333333033333333003333030333333033331
1300300033330333330330333333333333333303333303333300333333033333333300333303303033333300333333303301
1333330333303333303333003033333333333330030333333003330030333003033003330330333300033333303303000301
1333300333303303333030300333333333333333330300333330330303333330033330303003033330303333033333003331
1330333330033333330033333003333330030303300330333300033333303330033303033303333300330003330003030331
1330330330330333003333333333033033330330333333030030333033033330303003333333333030033333030330303331
1333333003033333033333303333030333033330303033300330030330303330300330033003303330030333303000303301
1333333333333330333033033033330303333303330333303033333333300300303033033003330333330300330333333331
1330003003030333333033300300333330333333330333303003333003333333333333000003303030333030333303300031
1330333333333303333033303303303030300333333303030330033303303333003300033330333300033330333033033031
1033033333033033003300300330303303303330333300303030333300303003330030330333333333333033303303030331
1000030333333333303333033333000330330333033300333333033303033333303030033300333333033303333333303301
1303003303330333333333333303300330030330030333300003333330033333330333333000003333333030033303333331
1033330333033303300033303333333033333003333033333033330300333333303330333033003033333333303300033301
1000333333303003033333033333333003333033303303003033333333303033000030033330300300333303300033000031
1033003333333033333330300333300333030333333033333303033333333333333303003303303303003003330333333331
1333330330333033333003300333003333330030333030333033303303003333033030303333303330003003330003333301
1330033303333000303033003333333033003303003333330333333333000033333333333333303333333333333003333001
1000033033033003033333333030303333333330033333303300333003333333330333033333333333300330300030333331
1333333333333303030000333333333330033033333303000330333330333303330033303333333330033300333000303331
1333303333303333303333033303333030330330330333333330033333003330033330033003333303333033333333003331
1333333303300333330330303003033033333330333300333030333030333033303333303330333333033030330333303031
1303330303033303303033303333033033333333330333003033300333303333300330330333330333330330333033333331
1033003333333330333303333303303030333333033333303333333033333333300333303333033303333330303303003331
1303333003303330330303333033033300333033300003333330303330003333030333030333033333333330033333333031
1033033303333330333333303303030333003330303033003303003333030330333300300303333333330303330033333331
1303033000333333303330300330303333003003033033333033033333333300030300033330333330333300303030303301
1030330303300033303333333333333033303333300033303033333000000003333333333033303000333030033300303031
1303333333033333030333303333033330033033303333303000000333330303330303033330300333333330303333030331
1033030333333033330030030333333333333003300303303333303333333033333303330003330000300003333333000331
1330333330333033333333333330333303333333333330300333333333030333303333033003303330333333033303333001
1033300333333303330033000333330333303333033000003003033333333030033030333030330333303333333330333031
1000333333333333303303333330303033333033333303003330303333033030330030333303330000303333333303033331
1303333000333303333033333333033330330333303003330303333033033300030033333303303033300303303303033001
1330030333300003003333330303330033333033303030330030030030333333333303333330030300003033000303033331
1300303333333333033333033033003303330033033300333330033333033033003333330033003030033333030303030031
1333333333000300033333333030330003030303333303330303333303030330003333333333000003303330333330300331
1303333033333333333333333303303033300033303033330300033303300030333003330033333330333333333333030031
1033330303033000333033303330033303303333303333000330033330303033030033333300000033330333333303300301
1303303033033333030333300333330333333333330030300030033330333300030033333303333330033033003030303301
1003330033003333303333300300303003330333033303333333333303333303033333333000333003303303033333033031
1333000033333333303303333303333033300303333330333333303003003033303333330333000333333033030333303301
1003330333330033033303330333003333330333333303003333333333333333333333003333330300333030330030333331
1333333330300333033303033303330333033300333330030330333333003333003033330333333333330000303330333331
1303033000330033303303303330003330333333033033333030303330033000333030033303333330000333303300333031
1333030303033330003330330003300333033330330333333333330030333330033333333333303030333000333030033301
1333003033303303330333033003333030033303303303033033333303333330333330000003330303333333033333030001
1033033333033333030330303303330330330303330333333333333033300303333333300333330033303033300033333031
1003303333330333333333303330303333003303333033333333303000330033033333333033330300033033333033030031
1300003333330333333033333303330333333333330303033033333303333330333003333333003030333330330333333331
1330303333030033333333300333030333033003330300003030333303033333303333300003330333333333333033303331
1000003333303330030033033330330300033333333333333333030330003330000333033333303003303333003333333331
1333030333303030333333330333033333300330303333333330333033333333330303300303300333033330333333333331
1333033003303333330303333300333330300333330033033303330033303333033303300303333033303303033030333331
1033303333030303303333003333003330303303033000033303030303333330000003330330333033000333033330030331
1003333333030303033330333333330030333333330033330033330333333300303303330330303330333330033000333301
1303330303330333000333333333303303003303030033033333003030333033333003033303333333333330003303033331
1333300030333003303033333333333033303303330033333003333030303033333330333300033300033303303333003331
1333303303333300000333330333303003330033003303330333333333333333333300033333333303330033303033033331
1333333033303333303033333033333003333333030003333333303003303030333330333033330000300333330303033031
1333333003330333000303333333333000003033333303033333333330333333333333330330033303303003330333300051
1111111111111111111111111111111111111111111111111111111111111111111111111111111111111111111111111111
