33333333333322211121111111111111111111111111111111111111111111111
33333333332211110012333222222222222222222111111111111111111111111
33333333322112200001222222222222222222222222222211111111111111111
33333333221162000000122222222222222222222333322222221111111111111
33333333221002000000012222222111111111222222222333322222111111111
33333332211002000000012222222222111100011112222222223332211111111
33333322100020003000012222222222222211100001122222222111111111111
33333322100020000000012111111222211122221000001112222222111111111
33333211000200000000121000000112222111222110000001122222211111111
33333210000200000000122100000001222221112221000000011222221111111
33333210000200000000001210000000112222211122100000000112222111111
33333210000200000000000121000000001122222112210000000001222211111
33333221000020000000000001222100000001222221112100000000011222111
33332121000000000000000000012210000000112222111210000000000122111
33332112100011101011111111100012100000000122221110000000000121211
33321012100010011000000000011111210000000112222111100000001232121
33321001210011000033333300011121000121111122221000000010123212111
33210012100100003333333300101221002120001122210000000001232121111
33210122100010033333222222221112211211200001222100000000123321211
33211122210001033333222222222211122121012010012221100000001233212
32112222210001333322222333001011212101121001122210000000123332111
32122222210001333322222333000100012100012100012221000000012111111
32222222210001333222223330000100000001112100001221000000121111111
32222222210001333222200000000000000000012222211001221100001211111
32222222221000133322220000330010000001122233210011221000012111111
32222222221000013322220000333310000001222330021100012100001211111
32222222222100001332222000000010000001222300003221110121000121111
32222222222100001133222200000100000001223000003332211110000121111
32222222221210000013222220001000000101220000333333222111101211111
32222222221121000001111222111000000121120003333333332221011211111
33222222221012000000000111000000000012110033333333333322202111111
33222222210012200000000000000110000012222233333333333332211111111
33222222210001110000000000001221000001111121111111111111111111111
33322222210000012200000000001222111000511121111111111111111111111
33322222100000011222000000001222221111222111111111111111111111111
33332222100000000111222000000122221111111111111111111111111111111
33333222100000000001212211111121111111111111111111111111111111111
33333221000000000012112222112211111111111111111111111111111111111
33333321000000000121011122212211111111111111111111111111111111111
33333321000000001210001211122211111111111111111111111111111111111
33333332100000012100001210122221111111111111111111111111111111111
33333332100000121000012101222211111111111111111111111111111111111
33333332100001210001121012222211111111111111111111111111111111111
33333332100121000122101222222111111111111111111111111111111111111
33333332101210001221112222221111111111111111111111111111111111111
33333333212100112111222222211111111111111111111111111111111111111
33333333221012321012222221111111111111111111111111111111111111111
33333333210123210122222211111111111111111111111111111111111111111
33333333321123211222222111111111111111111111111111111111111111111
33333333321232122222111111111111111111111111111111111111111111111
33333333332232222221111111111111111111111111111111111111111111111
33333333333322222111111111111111111111111111111111111111111111111
33333333333322211111111111111111111111111111111111111111111111111
33333333333322111111111111111111111111111111111111111111111111111
33333333333332111111111111111111111111111111111111111111111111111
